11111111111111111111111111111111111111111111111111111
1000000000000000000000001CCCCC000000000000000ECCCCCC1
1000000000000000000CC000100CCCCRCCCCCC00000111CCCCCC1
100000CCCCC00000000000001000000000000000000000CCCCCC1
1000CCCCGCCCCCCC000000001000001111111000000000CCCCCC1
100000CCCCCCCCCCCCC000001000000000000000000000CCCYCC1
1000000000000000000000000000000000000000000000CCCCCC1
1000001111111111111100001000000000000000000000CCCCCC1
1000000000000000000000001000000000000000000010CCCCCC1
1000000000CCCCCCCCC0B0001000CCC000000000000010CCCCCC1
1P0000000000000000000000100000000000000000001CCCCCCC1
11111111111111111111111111111111111111111111111111111
