11111111111111111111111111111111
1001C000000000000000000000000011
1001Y0000100000010001C0000000101
10010000001000001010001B00001001
10010000000100001000000100010001
10010000000010000000000000100001
100000000000010000000C0001000001
1000000C000000100000000010000001
10000000000000010000000100E00001
10010000000000000000000000000001
10010000000000000100010000000001
1001000C000000000010100000000001
10010000000000000001000000CG0001
10000000000000000000100000000001
10000000000000000010001000000001
10010000CR0000001000000100000001
10010000000000100000000010P00001
11111111111111111111111111111111
